R 1920 1080
NO tex/north.png
SO tex/south.png
WE tex/west.png
EA tex/east.png
S tex/sprite.png
F 80,100,20
C 0,100,220
1111111111111111111111111
1000000000110000001000001
1011000001110000000000001
1001000000000000000000001
111111111011000001010000000000001
100000000011000001010101111011111
11110111111111011100000011001
11110111111111011101000010001
11000000110101011100000010001
10002000000000001100000010001
10000000000000001100000010001
11000001110101011111N1111000111
11110111 1110101 101111010001
11111111 1111111 111111111111
